**********
*P       *
*        *
*        *
*   M    *
*        *
*   M    *
*        *
*       G*
**********